0 400 500 3 0
1 50 100 1
1 720 100 1
1 50 150 1
1 720 150 1
1 50 200 1
1 720 200 1
1 50 250 1
1 720 250 1
1 50 300 1
1 720 300 1
5 800 10 0 200
7 0