21 45
111111111111111111111111111111111111111111111
100000000000000000000000000000000000000000001
100000000000000000000000000000000000000000001
100001111111111111111111111111000030003000001
100000000000000000000000000001000030003000001
100000000000000000000000000001000030003000001
100001111111111111111111111111000030003000001
100001000000000000000000000000000030003000001
100001000000000000000000000000000030003000001
100001000000000000000000000000000030003000001
100001111111111111111111111111000030003000001
100000000000000000000000000001000030003000001
100000000000000000000000000001000030003000001
100001111111111111111111111111000030003000001
100001000000000000000000000000000030003000001
100001000000000000000000000000000030003000001
100001000000000000000000000000000030003000001
100001111111111111111111111111000030003000001
100000000000000000000000000000000000000000001
100000000000000000000000000000000000000000001
111111111111111111111111111111111111111111111
