23 45
111111111111111111111111111111111111111111111
100000000000000000000000000000000000000000001
100000000000000000000000000000000000000000001
100000000000000111111111111111000000000000001
100003330001110001111111111111033300011110001
100000000000000000000000000000030000030000001
100000000000000000000000000000030000030000001
100003330001110001111111111111033300011110001
100000000000000111111111111111000000000000001
100000000000000000000000000000000000000000001
101111111111111111110001111111111111111111111
101111111111111111110001111111111111111111111
100000000000000000000000000000000000000000001
100000000000000000000000000000000000000000001
100000000000000111111111111111000000000000001
100003330001110001111111111111033300011110001
100000000000000000000000000000030000030000001
100000000000000000000000000000030000030000001
100003330001110001111111111111033300011110001
100000000000000111111111111111000000000000001
100000000000000000000000000000000000000000001
100000000000000000000000000000000000000000001
111111111111111111111111111111111111111111111
